Arenicos = Арэнікос
Arkits = Аркітс
Aserai = Эсерай эсерайцаў
Battania = батанія Батанійскі
Byalic = Баялік
Calradia = Кальрадыі Кальрадыйскі Кальрадыйцы
Karakhergits = Карахергітс
Khergits = Хергітс
Kheshig = Хэшыг
Khuzait = Хузаіт
MVP = Самы каштоўны гулец = СКГ
N/A = НП
Nachaghan = Начагэн
Nahasa = Нахаса
Nordlands = Нордланд
Pendraic = Пэндрэіке
Sturgia = стургія Стургійскі стургійцы
Urkhun the Great = Урхун Вялікі
Vlandia = вландыі вландыяне вландыйцам
alley = завулак
ammo = снарадаў
aquaduct = акведук
attribute = атрыбут
badge = значок
behavior = паводзіны
boosting = Фарсаванне
braced polearm = умацаванне дзіды
cavalry = конніца
character = персанажа
charcoal = дрэвавага вугалю
charge = напор
charging = атакаваць
cheat = Чыт
cheer = радавацца
cohesion = згуртаванасць
commendations = падхяка
conformity = падначальванняы
conformity = пакора
consider = Абмеркаваць
contract = Дамова
control = кіраваннe
couch Lance = Наезд дзідай
council = рада
courtship = Заляцанне
courtyard = дзядзінец
decisions = пастановы
denars = дэнары
devastate settlement = спустошыць селішча
dungeon = вязніца
encounter = сутыкненне
encumbrance = нагрузка
endurance (END) = трываласць (ТРЫ), Intelligence (INT) = Інтэлект (ІНТ), Кантроль (КАН) = control (CTR), Cunning (CNG) = Хітрасць (ХІТ), Social (SOC) = Сацыяльнасць (САЦ), Vigor (VIG) = дужасць (ДУЖ)
enterprises = прадпрыемстваў
fief = феод
focus points = ачкі фокуса
forfeit = Штраф
formation = пабудова
gambling dens = гульнявых прытонаў
governed = кіраваны
handling = кіруемасць
hardwood = драўніны
harness = вупраж
hearth = агменю
hideout = Сховішча
hit Points = здароўе
honor = Гонар
incursions = набегі
insulted = абразіў
item = прадмет
jewelery = каштоўнасцяў
keep = вязніца
kick = штуршок, штурхаля
kiln = печ
knockdown = накдаўн
knocked unconscious = знепрытомеў прытомнасць
lance = дзіда
liege = сеньёр
line, Loose, Circle or Scatter = Лінія, Россып, Кольца ці Роскід
marketplace = Кірмаш
matchmaking = стварэння матча
mercenaries = наймітаў
militia = Рушэнне
mount = Конь
murder hole = адтуліны для забойстваў
mute = Заглушыць
noble = шляхціч
notable = натабль
noyans = ноян
npc = нгп
of the Chosen = з Абраных
of the Covenant = з Запавету
of the Hills = з Узгоркаў
of the Keepers = з Захоўнікаў
of the Lakepike = з Азёрных шчупакоў
of the Wastes = з Адкідаў
oil = алей
outputs = Прыбыткі
pack animals = уючных
party = партыя
perk = перавага
persuade = пераканаць
polearm = дзіда (калі зброя) тронкавай зброі (калі навык)
policy = палітыкі
pottery = ганчарных вырабаў
practice mp = трэніроўка
premade = Ствараемай
prosperity = Росквіт
raid = рабаваць калі дзеянне або рабаванне вёскі, але ваяры гэта рэйдары
ram = Тараны
ranked = Рэйтынгавы
rebels = Паўстанцы
refine = паляпшэнне
relation = адносіны
renown = вядомасць
report = скаргі
respawn = адраджэнне
rogue = нягоднік
ruler = валадар
sallying out = выбег
sallying out = вылазца
scoreboard = дошку вынікаў
shared experience = агульнага досведу
sigil = герб
skill = навык
skirmish = Сутычка (конь)
skirmishing = атакаваць
slots = вочка вочак
smelt = плаўлення
smithy Stamina = Стомленасць каваля
sold = Сбыты
spawn = адраджэнне
stock = запас
swing = Рэжучы 
swing Speed = рэжучай хуткасці
tab = закладца
throwing weapons = кідальная зброя
thrown weapons = кідальнай зброяй
thrust Damage = колючая шкода хуткасць уколу
thugs = бандыты
tier = Узровень
traits = асаблівасці
tribute = даніна
troop = ваяр
tutorials = падказкі
upgrade = Паляпшэнні
village = вёска
wage = выдаткі
weak = нядужы
wealth = багацця
workshop = майстэрня
worth = вартасць
wounded = ранены
yield = прыбытак
