
Altdorf = Альтдорф
Aver = Авер
Blackfire Pass = Перавал Чорнае Полымя
Braganza = Браганза
Bretonnia = Брэтоньнія, брэтонскі, брэтоньцы
Bright Wizard = Зыркі Чараўнік
Crossed Keys = Скрыжаваныя Ключы
domain = валадарства
Drakenhof = Дракенхоф, дракенхофскі
Dwarfen Kingdoms = Гаспадарствы Гномаў
Greatswords = Выдатныя мячы
Khorne = Кхорн
Lammer = Ламмер
Lord (Empire, Vampire) = Шляхціч
Neutral = Нейтрал
Nuln = Нульн, нульнскі
Nurgle = Нургл
Old Dwarf Road = Стары Шлях Гномаў
Reik = Райк
Reiksguard = Райксгард, райксгардзкі
Reman = Рыман, рыманскі, рыманцы
Shallya = Шалья
State = Дзяржаўны
Stir = Шцір, шцірскі
Sylvania = Сільванія, сільванскі
Taal = Тайл
Troop = жаўнер
Ungor = Нярох
Voland = Воланд
Von Carstein = фон Карштайн
Von Kragsburg = фон Краксбург
Wailing Woods = Лес Плачу
Wight King = Вайскавод-Мярцвяк
Wizard = Чараўнік
Wizard = Чараўнік
