Bravos = Бравос, Бравоскі
Dornish = Дорн, Дарнійскі
Dothraki = Дотракі, Дотракійскі
Dragonstone = Цмачыны Камень
Essos = Усходас
Free Cities = Вольных Гарадах
Free Folk = Вольны Народ
Free Houses = Вольныя Дамы
House Targaryen = Дом Таргарыен
Ironborn = Жалезнанароджаны
Khal = Хал 
Lorath = Лорат
Lys = Лыс
Mountains of the Moon = Гор Месяца
Myr = Мыр
Nights Watch = Начны Дазор
Norvos = Норвас
Pentos = Пэнтос
Pyke = Пік
Qohor = Кохар
Riverlands = Рачныя Землі
Sarnor = Сарнор
Septon = Сэптон
Seven-Pointed Star = Сяміканцовай Зоркі
Skagos = Скагос
Stormlands = Штармавыя Землі
Tyrosh = Тайрош
Vale of Arryn = Даліна Аррын
Volantis = Валанціс
westerlands = Заходні Край, Заходне-Краёвы
Hollow Hill = Парожніх Узгоркаў