
Alan = Аланскі, Аланы
Arab = Арабскі, Арабы
Aragonese = Арагон, Арагонскі
Berber = Берберскі, Берберы
Byzantine = Бізантыя, Бізантыйскі, Бізантыйцы
Cuman = Палавецкі, Полаўцы
Danish = Данія, Дацкі, Датчане
English = Англія, Англійскі, Англічане
Fatimid = Фацімідзкі, Фаціміды
Frankish = Францкі, Франкі
Friisian = Фрызійскі
Gaelic = Гэлы, Гэльскі
German = Германія, Германскі, Германцы
Goidelic = Гоідэлы, Гоідэльскі
Hungarian = Вугорыя, Вугорскі, Вугорцы
Iberian = Іберыйскі
Irish = Ірландыя, Ірландзкі, Ірландцы
Italian = Італія, Італьянскі, Італьянцы
Kipchaks = Кіпчакі, Кіпчаскі
Magyar = Мадзярскі, Мадзяры
Nordic = Нардычны, Норды
Norman = Нарманскі, Нарманы
Norse = Нарвегія, Нарвескі, Нарвежцы
Outremer = Утрумэр, Утрумэрскі, Утрумэры
Persian = Персія, Персіцкі, Персы
Pisans = Піза, Пізанскі, Пізанцы
Polish = Польшча, Польскі, Палякі
Prussian = Прусія, Прускі, Прусы
Saracen = Сарацынскі, Сарацыны
Scottish = Шатландыя, Шатландзкі, Шатландцы
Seljuk = Сельджускі, Сельджукі
Serbian = Сербія, Сербскі, Сербы
Sicilian = Сіцылія, Сіцылійскі
Spanish = Гішпанія, Гішпанскі, Гішпанцы
Taureg = Туарэг, Туарэскі
Turco = Цюркі, Цюрска
Turkish = Турцыя, Турэцкі, Туркі
Varangian = Вараскі, Варагі