Agama = Агама
Ardron = Ардрон
Banish Land = Зямлю Выгнання
Cagie = Кэжы
Couch Lance = Наезд дзідай
Custom Troop, Customized Troops = наладжвальныя ваяры, наладжвальных ваяроў
Derian = Дзірыян
Elin = Элін, эліны, элінская
Geliran = Гелірэн
grassland king = Караля Стэпаў
Grode = Гроўд
Icey = Айсі
Lomoca = Ламока, ламокійцы, ламокійскія
Lorin = Лорын
Lotas = Лотас
Melethvon = Мелетвон
Mogrian = Могрыя, могрыйцы, могрыйскія
Monnai = Моннай
Navi = Наві
Nekenia = Некенія, некенійцы, некенійскія
Pet = гадаванец, гадаванцаў
Prouen = Пруэн, пруэнійцы, пруэнійскія
Rabblam = Рабблам, раббламійцы, раббламійскія
Radruweel = Радрувіл
Ryenus = Раінэс
Sally = Салі
Sika = Сіка, Край Сіка, сіканцаў
Slavers = гандляроў рабамі
Spear Brace = Дзіду ў Зямлю
The Land Of Sika = Зямля Сіка
Vilken = Вілкен
Vultur = Вальтура
Wulltes = Вульціс, вульцісійцы, вульціскія
Xiang = Сян
Yan = Янь, яньцы, яньскія
Yarian = Ярын, ярынцы, ярынскія